Sex & Candy - Marcy Playground
Time of Your Life (Good Riddance) - Green Day
Everything to Everyone - Everclear
3 AM - Matchbox 20
Bitter Sweet Symphony - The Verve
You Were Meant for Me - Jewel
Touch, Peel and Stand - Days of the New
How's It Going to Be - Third Eye Blind
Tubthumping - Chumbawamba
Brick - Ben Folds Five
Mouth (So Hot Because I Said So) [Soundtrack Version] - Merril Bainbridge
Clumsy - Our Lady Peace
Walkin' on the Sun - Smash Mouth
Dammit (Growing Up) - Blink-182
Sweet Surrender - Sarah McLachlan
Deadweight - Beck
Torn - Natalie Imbruglia
Whims of Asha (When He Was Born for the Seventh Time) - Cornershop
Fly - Sugar Ray
Criminal - Fiona Apple
Sugar Kane - Son Volt
My Own Prison - Creed
Washing My Hair - The Mighty Mighty Bosstones
The Mummers' Dance - Loreena McKennitt
Royal Oil - The Mighty Mighty Bosstones
Jane Says (Live) - Jane's Addiction
Beautiful Disaster - 311
Don't Go Away - Oasis
Karma Police - Radiohead
Hitchin' a Ride - Green Day
I'm Afraid of Americans - David Bowie
Lucky - Seven Mary Three
Rolling Stones - G. Love & Special Sauce
Summertime - The Sundays
The Chanukah Song - Adam Sandler
Rattlesnake - Rustic Overtones
The Ghost of Tom Joad - Rage Against the Machine
Fall on Tears - Tricky
Given to Fly - Pearl Jam